"filename", "language", "Markdown", "C++", "CMake", "comment", "blank", "total"
"/Users/jamesweigand/Desktop/Carbon/Carbon/CMakeLists.txt", "CMake", 0, 0, 38, 0, 6, 44
"/Users/jamesweigand/Desktop/Carbon/Carbon/README.md", "Markdown", 2, 0, 0, 0, 1, 3
"/Users/jamesweigand/Desktop/Carbon/Carbon/src/asset.cpp", "C++", 0, 790, 0, 205, 245, 1240
"/Users/jamesweigand/Desktop/Carbon/Carbon/src/asset.hpp", "C++", 0, 131, 0, 15, 13, 159
"/Users/jamesweigand/Desktop/Carbon/Carbon/src/balloon.cpp", "C++", 0, 1220, 0, 610, 394, 2224
"/Users/jamesweigand/Desktop/Carbon/Carbon/src/balloon.hpp", "C++", 0, 42, 0, 39, 7, 88
"/Users/jamesweigand/Desktop/Carbon/Carbon/src/bitmap.cpp", "C++", 0, 70, 0, 2, 26, 98
"/Users/jamesweigand/Desktop/Carbon/Carbon/src/bitmap.hpp", "C++", 0, 45, 0, 0, 7, 52
"/Users/jamesweigand/Desktop/Carbon/Carbon/src/bitmap_render.cpp", "C++", 0, 53, 0, 2, 13, 68
"/Users/jamesweigand/Desktop/Carbon/Carbon/src/bitmap_render.hpp", "C++", 0, 34, 0, 9, 6, 49
"/Users/jamesweigand/Desktop/Carbon/Carbon/src/bitstream.cpp", "C++", 0, 209, 0, 38, 66, 313
"/Users/jamesweigand/Desktop/Carbon/Carbon/src/bitstream.hpp", "C++", 0, 58, 0, 7, 10, 75
"/Users/jamesweigand/Desktop/Carbon/Carbon/src/bytestream.cpp", "C++", 0, 644, 0, 156, 191, 991
"/Users/jamesweigand/Desktop/Carbon/Carbon/src/bytestream.hpp", "C++", 0, 135, 0, 30, 24, 189
"/Users/jamesweigand/Desktop/Carbon/Carbon/src/crc.cpp", "C++", 0, 10, 0, 0, 4, 14
"/Users/jamesweigand/Desktop/Carbon/Carbon/src/crc.hpp", "C++", 0, 57, 0, 0, 2, 59
"/Users/jamesweigand/Desktop/Carbon/Carbon/src/date.cpp", "C++", 0, 139, 0, 36, 25, 200
"/Users/jamesweigand/Desktop/Carbon/Carbon/src/date.hpp", "C++", 0, 37, 0, 0, 4, 41
"/Users/jamesweigand/Desktop/Carbon/Carbon/src/filepath.cpp", "C++", 0, 50, 0, 5, 24, 79
"/Users/jamesweigand/Desktop/Carbon/Carbon/src/filepath.hpp", "C++", 0, 41, 0, 5, 9, 55
"/Users/jamesweigand/Desktop/Carbon/Carbon/src/json.cpp", "C++", 0, 466, 0, 75, 87, 628
"/Users/jamesweigand/Desktop/Carbon/Carbon/src/json.hpp", "C++", 0, 0, 0, 0, 1, 1
"/Users/jamesweigand/Desktop/Carbon/Carbon/src/linked_map.hpp", "C++", 0, 132, 0, 50, 30, 212
"/Users/jamesweigand/Desktop/Carbon/Carbon/src/measure.hpp", "C++", 0, 20, 0, 0, 2, 22
"/Users/jamesweigand/Desktop/Carbon/Carbon/src/memcpy.cpp", "C++", 0, 747, 0, 26, 67, 840
"/Users/jamesweigand/Desktop/Carbon/Carbon/src/memcpy.hpp", "C++", 0, 21, 0, 0, 3, 24
"/Users/jamesweigand/Desktop/Carbon/Carbon/src/micro_vector.hpp", "C++", 0, 55, 0, 16, 12, 83
"/Users/jamesweigand/Desktop/Carbon/Carbon/src/msutil.hpp", "C++", 0, 275, 0, 27, 58, 360
"/Users/jamesweigand/Desktop/Carbon/Carbon/src/ttf.cpp", "C++", 0, 290, 0, 107, 88, 485
"/Users/jamesweigand/Desktop/Carbon/Carbon/src/ttf.hpp", "C++", 0, 113, 0, 10, 15, 138
"/Users/jamesweigand/Desktop/Carbon/Carbon/src/ttf_render.cpp", "C++", 0, 235, 0, 66, 70, 371
"/Users/jamesweigand/Desktop/Carbon/Carbon/src/ttf_render.hpp", "C++", 0, 26, 0, 0, 4, 30
"/Users/jamesweigand/Desktop/Carbon/Carbon/src/types.hpp", "C++", 0, 23, 0, 4, 10, 37
"/Users/jamesweigand/Desktop/Carbon/Carbon/src/xml.cpp", "C++", 0, 585, 0, 69, 134, 788
"/Users/jamesweigand/Desktop/Carbon/Carbon/src/xml.hpp", "C++", 0, 99, 0, 8, 16, 123
"Total", "-", 2, 6852, 38, 1617, 1674, 10183