"filename", "language", "C++", "Markdown", "CMake", "comment", "blank", "total"
"/Users/jamesweigand/Desktop/Carbon/Carbon/CMakeLists.txt", "CMake", 0, 0, 41, 0, 5, 46
"/Users/jamesweigand/Desktop/Carbon/Carbon/README.md", "Markdown", 0, 26, 0, 0, 5, 31
"/Users/jamesweigand/Desktop/Carbon/Carbon/README_BACKUP_25526.md", "Markdown", 0, 26, 0, 0, 5, 31
"/Users/jamesweigand/Desktop/Carbon/Carbon/README_BASE_25526.md", "Markdown", 0, 2, 0, 0, 1, 3
"/Users/jamesweigand/Desktop/Carbon/Carbon/README_LOCAL_25526.md", "Markdown", 0, 11, 0, 0, 2, 13
"/Users/jamesweigand/Desktop/Carbon/Carbon/README_REMOTE_25526.md", "Markdown", 0, 11, 0, 0, 3, 14
"/Users/jamesweigand/Desktop/Carbon/Carbon/src/asset.cpp", "C++", 789, 0, 0, 205, 244, 1238
"/Users/jamesweigand/Desktop/Carbon/Carbon/src/asset.hpp", "C++", 131, 0, 0, 15, 13, 159
"/Users/jamesweigand/Desktop/Carbon/Carbon/src/balloon.cpp", "C++", 1220, 0, 0, 610, 394, 2224
"/Users/jamesweigand/Desktop/Carbon/Carbon/src/balloon.hpp", "C++", 42, 0, 0, 39, 7, 88
"/Users/jamesweigand/Desktop/Carbon/Carbon/src/bitmap.cpp", "C++", 69, 0, 0, 2, 25, 96
"/Users/jamesweigand/Desktop/Carbon/Carbon/src/bitmap.hpp", "C++", 45, 0, 0, 0, 6, 51
"/Users/jamesweigand/Desktop/Carbon/Carbon/src/bitmap_render.cpp", "C++", 52, 0, 0, 2, 12, 66
"/Users/jamesweigand/Desktop/Carbon/Carbon/src/bitmap_render.hpp", "C++", 34, 0, 0, 9, 6, 49
"/Users/jamesweigand/Desktop/Carbon/Carbon/src/bitstream.cpp", "C++", 209, 0, 0, 38, 66, 313
"/Users/jamesweigand/Desktop/Carbon/Carbon/src/bitstream.hpp", "C++", 58, 0, 0, 7, 10, 75
"/Users/jamesweigand/Desktop/Carbon/Carbon/src/bytestream.cpp", "C++", 647, 0, 0, 156, 192, 995
"/Users/jamesweigand/Desktop/Carbon/Carbon/src/bytestream.hpp", "C++", 138, 0, 0, 31, 26, 195
"/Users/jamesweigand/Desktop/Carbon/Carbon/src/color.cpp", "C++", 46, 0, 0, 0, 14, 60
"/Users/jamesweigand/Desktop/Carbon/Carbon/src/color.hpp", "C++", 36, 0, 0, 8, 5, 49
"/Users/jamesweigand/Desktop/Carbon/Carbon/src/crc.cpp", "C++", 10, 0, 0, 0, 4, 14
"/Users/jamesweigand/Desktop/Carbon/Carbon/src/crc.hpp", "C++", 57, 0, 0, 0, 2, 59
"/Users/jamesweigand/Desktop/Carbon/Carbon/src/date.cpp", "C++", 139, 0, 0, 36, 25, 200
"/Users/jamesweigand/Desktop/Carbon/Carbon/src/date.hpp", "C++", 37, 0, 0, 0, 4, 41
"/Users/jamesweigand/Desktop/Carbon/Carbon/src/filepath.cpp", "C++", 50, 0, 0, 5, 24, 79
"/Users/jamesweigand/Desktop/Carbon/Carbon/src/filepath.hpp", "C++", 41, 0, 0, 5, 9, 55
"/Users/jamesweigand/Desktop/Carbon/Carbon/src/filestream.cpp", "C++", 18, 0, 0, 0, 6, 24
"/Users/jamesweigand/Desktop/Carbon/Carbon/src/filestream.hpp", "C++", 11, 0, 0, 0, 1, 12
"/Users/jamesweigand/Desktop/Carbon/Carbon/src/filewrite.cpp", "C++", 28, 0, 0, 7, 12, 47
"/Users/jamesweigand/Desktop/Carbon/Carbon/src/filewrite.hpp", "C++", 12, 0, 0, 0, 2, 14
"/Users/jamesweigand/Desktop/Carbon/Carbon/src/json.cpp", "C++", 465, 0, 0, 75, 85, 625
"/Users/jamesweigand/Desktop/Carbon/Carbon/src/json.hpp", "C++", 71, 0, 0, 4, 12, 87
"/Users/jamesweigand/Desktop/Carbon/Carbon/src/linked_map.hpp", "C++", 132, 0, 0, 50, 30, 212
"/Users/jamesweigand/Desktop/Carbon/Carbon/src/logger.cpp", "C++", 165, 0, 0, 11, 51, 227
"/Users/jamesweigand/Desktop/Carbon/Carbon/src/logger.hpp", "C++", 60, 0, 0, 18, 7, 85
"/Users/jamesweigand/Desktop/Carbon/Carbon/src/measure.hpp", "C++", 20, 0, 0, 0, 2, 22
"/Users/jamesweigand/Desktop/Carbon/Carbon/src/memcpy.cpp", "C++", 747, 0, 0, 26, 67, 840
"/Users/jamesweigand/Desktop/Carbon/Carbon/src/memcpy.hpp", "C++", 21, 0, 0, 0, 3, 24
"/Users/jamesweigand/Desktop/Carbon/Carbon/src/micro_vector.hpp", "C++", 55, 0, 0, 16, 12, 83
"/Users/jamesweigand/Desktop/Carbon/Carbon/src/msutil.hpp", "C++", 275, 0, 0, 27, 58, 360
"/Users/jamesweigand/Desktop/Carbon/Carbon/src/png.cpp", "C++", 398, 0, 0, 58, 88, 544
"/Users/jamesweigand/Desktop/Carbon/Carbon/src/png.hpp", "C++", 28, 0, 0, 0, 3, 31
"/Users/jamesweigand/Desktop/Carbon/Carbon/src/realigned_buffer.hpp", "C++", 31, 0, 0, 16, 9, 56
"/Users/jamesweigand/Desktop/Carbon/Carbon/src/silk.cpp", "C++", 62, 0, 0, 62, 21, 145
"/Users/jamesweigand/Desktop/Carbon/Carbon/src/silk.hpp", "C++", 67, 0, 0, 34, 12, 113
"/Users/jamesweigand/Desktop/Carbon/Carbon/src/ttf.cpp", "C++", 289, 0, 0, 107, 87, 483
"/Users/jamesweigand/Desktop/Carbon/Carbon/src/ttf.hpp", "C++", 113, 0, 0, 10, 15, 138
"/Users/jamesweigand/Desktop/Carbon/Carbon/src/ttf_render.cpp", "C++", 234, 0, 0, 66, 69, 369
"/Users/jamesweigand/Desktop/Carbon/Carbon/src/ttf_render.hpp", "C++", 26, 0, 0, 12, 5, 43
"/Users/jamesweigand/Desktop/Carbon/Carbon/src/types.hpp", "C++", 22, 0, 0, 4, 10, 36
"/Users/jamesweigand/Desktop/Carbon/Carbon/src/vec.cpp", "C++", 0, 0, 0, 0, 1, 1
"/Users/jamesweigand/Desktop/Carbon/Carbon/src/vec.hpp", "C++", 151, 0, 0, 3, 47, 201
"/Users/jamesweigand/Desktop/Carbon/Carbon/src/xml.cpp", "C++", 584, 0, 0, 69, 134, 787
"/Users/jamesweigand/Desktop/Carbon/Carbon/src/xml.hpp", "C++", 99, 0, 0, 8, 16, 123
"Total", "-", 8034, 76, 41, 1851, 1974, 11976